поехать в отпуск	go on holiday / vacation
отправиться в путешествие	go on a journey
отправиться в командировку	go on a business trip
поехать на экскурсию	go on an excursion
на курорте с миниральными водвми	at the spa resort
лыжный курорт	at the ski resort
принимать солнечные ванны	sunbathe (d)
загорать	tan (ned)
загар	tan
бездельничать	laze(d) around
лежать на пляже	lie on the beach
лежать лежал лежащий	lie lay lain
зависать	hang out
шариться	hang around
ехать за границу	go abroad
поехать смотреть достопремечательности	go sightseeing
достопремечательность	sight
хрен знает где	in the middle of nowhere
заводить друзей	make friends
общаться	communicate
