влюбиться в 	fall (fell, falen) in love (with sb)
привлекать	attract (ed)
подцепить кого то	pick (ed) sb up
ухаживать	woo
быть влюбленным в	be in love (with sb)
пригласить кого то на свидание	ask (ed) sb out
встречаться с 	to date sb
свидание	date
очаровывать	enchant (ed) инчент
обожать	adore (d)
желать себе	desire (d)
поклонник	admire
прогуливаться	to stroll (ed)
составить кому то компанию	keep sb company
провести кого то домой	see (saw, seen) sb home
представлять кого то кому то	introduce (d) sb to sb
значить (много) кому то	mean (meant, meant) (a lot) to sb
быть влюбленным в кого то	have a crush (on sb)
жаждать	to crave (d)
тот самый	the one
родственная душа	soulmate
с первого взгляда	ai first sight
