Акуратный по отношению к чему то	Cautious about smth
Акуратные делать что то	Cautious about doing smth
Скромный по поводу чего то	Modest about smth
Скрытный	Discreet about smth
Открытий / искренний	Be frank
Быть открытым с кем то	Be frank with sb
Быть открытым по поводу чего то	Be frank about smth
Искренее интервью	Frank interview
Полон интузиазма по поводу чегото 	Enthusiastic about smth
Полон интузиазма делать что то	Enthusiastic about doing smth
Задумчивый / продуманный	Thoughtful
Тчестлавный	Vain
Храбрый / смелый	Courageous
Жалкий	Pathetic
Наивный	Naive
Решительный 	Resolute
Открытый 	Sincere
Нерешительный	Indecisive
Надежный	Trustworthy
Прямолинейный	Outspoken
Непредсказумеый	Unpredictable
Ерудированый / утонченный	Sophisticated
Утонченный вкус / манеры	Sophisticated taste / manners
